_________
_________
____XXX__
___X_____
__X__XXX_
__X_XX_X_
__X_XG_X_
__X____X_
___XXXXX_
_S_______